########################################////////////////////////////////////////////////////////////////////////////###############################################....
#..................#####........########////////////////////////////////////////////////////////////////////////////#..................................................
#..................#####.............###////////////////////////////////////////////////////////////////////////////#..................................................
#......................................#////////////////////////////////////////////////////////////////////////////#..................................................
#............###..........####.........#////////////////////////////////////////////////////////////////////////////#..................................##..............
#............###..........####.........#////////////////////////////////////////////////////////////////////////////#..................................############....
#......######################################################################///////////////////////////////////////#..................................#
#............................................................................#//////////////////////////////////////#..................................#
#............................................................................#//////////////////////////////////////#..................................#
#............................................................................#//////////////////////////////////////#..................................#
#########..###############################..###############################..#//////////////////////////////////////#..................................#
#.........................#..................................................#//////////////////////////////////////#..................................#
#.........................#..................................................#//////////////////////////////////////#..................................#
#.........................#..................................................#//////////////////////////////////////#..................................#
#..#####################..#.................................................##//////////////////////////////////////#..................................#
#..#......................######################################.............#//////////////////////////////////////#..................................#
#..#......................#..................................................#//////////////////////////////////////#..................................#
#.........................#..................................................#//////////////////////////////////////#..................................#
#.........................#..................................................#//////////////////////////////////////#..................................#
####################..####################.........#############################################################################.......################
#.......................######......................................######################..............................................................#
#.......................#####....................................................####...##.............................................................#
#......................#####.....................................................####....##............................................................#
#..########################........##################..###########...............$........##...........................................................#
#........................#........##...................##........##.......###....$.........##..........................................................#
#........................#.......##....................##.........##......###....$..........##########.................................................#
#........................#......##.....................##..........##.............$....................................................................#
###########..........#####......##.....................##...........##.............####................................................................#
#.....................#..#......#####........##########..............##...........##...................................................................#
#.........#...####....#..#...............#.............#..............##.........##........##########..................................................#
#..#####..#..######...#..#...............#.............##.............##........##...................#.................................................#
#..#...#..#...######..#..#############...#..............##............##.......##....#...............#.................................................#
#..#......#....####...#..............##..#########......##............##......##....#................#.................................................#
#..#......#....####...#..............##..#...............##..####...##########################.......#.................................................#
#..#......#....####...#..............##..#...............##....#........###########....$......##....#..................................................#
#..#......#....####...#..............##..#................##...#.......................$..@.....####...................................................#
#..#......#....####...#..............##..#................##...#.......................$...............................................................#
#..#......#....####...#.............##...######....#####...##..#..#..#.....###.........#######.........................................................#
#..#..#####....####....#...........##....#........##..##..###..#..#..#....###......#..#.......#........................................................#
#..#......#.......##....#.........##.....#........##....#####..#..#..#...###.......#..#........######################$$##################..............#
#..#......#.......##.....#.......##......#.......##......###...#..#..#..##.........#..#....#..............#######................#.....................#
#..#......$.......##.....#......##.......#......##.............#..#..#..##.........#.......#.....................................#.....................#
#..#..#...$...######.....#......##.......##.....##......#########..##...##.........#.......#.....................................#.....................#
#..#####..$...######....#.....##.........###....##.....##.......##......##........#........##......................############..#.....................#
#$$#####################.....##..........####...########.........#####...######################################################..##########################
#.......................$...##...........#####............................................................................................................#
#........................$.##............#####...........#######..........................................................................................#
#.........................##.............#####..........#########.........................................................................................#
########################################################################################################################################################..#
///////////////////////////////////////////////////////////////////////////////////////////////////////////////////////////////////////////////////////#$$#
///////////////////////////////////////////////////////////////////////////////////////////////////////////////////////////////////////////////////////#$$#
///////////////////////////////////////////////////////////////////////////////////////////////////////////////////////////////////////////////////////#$$#
///////////////////////////////////////////////////////////////////////////////////////////////////////////////////////////////////////////////////////#$$#
///////////////////////////////////////////////////////////////////////////////////////////////////////////////////////////////////////////////////////#$$#
///////////////////////////////////////////////////////////////////////////////////////////////////////////////////////////////////////////////////////#$$#
///////////////////////////////////////////////////////////////////////////////////////////////////////////////////////////////////////////////////////#$$#
///////////////////////////////////////////////////////////////////////////////////////////////////////////////////////////////////////////////////////#$$#
///////////////////////////////////////////////////////////////////////////////////////////////////////////////////////////////////////////////////////#$$#
///////////////////////////////////////////////////////////////////////////////////////////////////////////////////////////////////////////////////////#$$#
///////////////////////////////////////////////////////////////////////////////////////////////////////////////////////////////////////////////////////#$$#
///////////////////////////////////////////////////////////////////////////////////////////////////////////////////////////////////////////////////////#$$#
///////////////////////////////////////////////////////////////////////////////////////////////////////////////////////////////////////////////////////#$$#
///////////////////////////////////////////////////////////////////////////////////////////////////////////////////////////////////////////////////////#$$#
///////////////////////////////////////////////////////////////////////////////////////////////////////////////////////////////////////////////////////#$$#
///////////////////////////////////////////////////////////////////////////////////////////////////////////////////////////////////////////////////////#$$#
///////////////////////////////////////////////////////////////////////////////////////////////////////////////////////////////////////////////////////#$$#
///////////////////////////////////////////////////////////////////////////////////////////////////////////////////////////////////////////////////////#$$#
///////////////////////////////////////////////////////////////////////////////////////////////////////////////////////////////////////////////////////####

