##############################
#............................#
#.........@..................#
#............................#
#########################....#
////////////////////////#....#
////////////////////////#....#
////////////////////////#....#
////////////////////////#....#
////////////////////////#....#
////////////////////////#....#
/##################/////#....#
#.................#######....#####
#................................#
#................................#
#................................#
#......................$..........#
#.....############...............#
#.....#..........#...............#
#.....#..........#...............###################################################################################################################
#.....#..........#..................................................................................................................................#
#.....#..........#..................................................................................................................................#
#.....#..........#..................................................................................................................................#
#.....#..........#..................................................................................................................................#
#.....#..........#..................................................................................................................................#
#.....#..........#..................................................................................................................................#
#.....#..........#...............###################################################################################################################
#.....#..........................#
#.....#..........................#
#.....#..........................#
##################################